24 16
000000000001000000000000
011111111101011111111110
010000000000000000000000
010111111111011111111110
010100000000000100000010
010101001000000100101010
000001000011010000101000
110101000010010011101011
000101110010010000100000
010101000010110000101010
010101001000000100101010
010000001000000000001010
011111111110111111111010
000000000000000000000010
011111111110101111111110
000000000000100000000000