24 16
000000000111000000000000
010101010101010101010101
000000000000000000000000
101010101010101010101010
000000000000000000000000
101010101010101010101010
000000000000000000000000
101010101010101010101010
000000000000000000000000
101010101010101010101010
000000000000000000000000
101010101010101010101010
000000000000000000000000
101010101010101010101010
000000000011100000000000
000111000000000000011100




