24 16
000000000000000000000000
000100011100011100011100
000100111110111110100010
011100111110111110000010
000100111110111110001100
000100011110011110000010
100100000010000010100010
000100000010000010011100
000000000000000000000000
011110111010010111011100
000010111010010100011110
000100111011010100011110
001000111010110110011100
010000111010010100010100
011110111010010111010010
000000000000000000000000
